####################################################################################################
#A       #                     #                                                                 #
#    #####    ##############   #   #########   #########   #########   #######     ############   #
#    #        #        #   #   #   #                 #     #       #   #     #     #          #   #
#    #    #####        #   #   #####                 #     #       #   #     #     #          #   #
#    #    #            #   #                 #############       #     #     #####   ############   #
#    #    #    #########   ##################################    ############                  #
#    #    #    #                          #           #    #     #                             #   #
#    #    #####                          #    ###### #    #     #                             #   #
#    #########    ###################    #    #         #     #                             #   #
#            #    #               #  #    #    #         ###########    #####################   #
#            #    #   #############  #    #    #         #    #    #    #                       #
#            #####   #              #####    #    #########    #    #    #                       #
#                #   #              ###      #              #    #    ###########################   #
#                #   ##############  #    ######          #    #    #    #                       #
#                #####            ###    #             #    #    ######   #                       #
#                    #    ########  #    ##########    ######       # #   ###########################
#                    #####           #              #    #        #  #                            #
#                        #########   #   ########   #    #        #  #       #####################   #
#                                 #   #   #       #   #    #        #  #       #                    #
#   #############################   #####   #       #   #    #        #  #       #                    #
#   #                                #   #   ########   #   ########  #  #       ##########           #
#   #    ############################   #   #                 #      #  ##       ########## ######    #
#   #    #                         #    ################     #   #    ####       #                           #
#   #    #   #####################   #                    #    #   #######       #                           #
#   #    #   #                   ###    ###########    #    #####   #####   ################ #####   #
#   #    #   #   ##############   ##    #           #    #    #        #    #                 #      #
#   #    #   #   #             ##   #####          ###########    #####    ################   #       #
#   #    #   #   ########## ##                     #                       #                 #        #
#   #    #   #####        # ##    #############    ########################       ########## ###    #
#   #    #####             ################## ###              #                #                    #        #
#   #########    ################################   ###########    #############################   #
#                                                #B                                    ##########  #
####################################################################################################