#####B####
##### ####
####  ####
####  ####
####  ####
####  ####
####  ####
#### #####
     #####
A#########
