           #   #         # #     # #     #   #   #     #   #       #               #       #   #   # 
 A#### ### ### # ####### # # # # # ##### # # # # # ### # # # ##### # # ########### # ####### # ### ##
     #   #       # #     #   # # #     #   # # # #   #   # #     # # # #         # #   #     #   #   
#### ### ######### # ######### ############# # ##### ##### ##### # # # # ####### # ### # ####### ### 
     #   #       # # #       #             # #   # #     # #   # # # #   #     # # #   # # #     #   
 ##### ### ##### ### # ##### ########### # ##### # ##### # ####### ####### ### # # # ### # # ##### ##
     #   # #   #   # #   ### #   #     # #     # #       # #     #   # #   #   # #   #   #   # #     
#### ### # # ### # # ####### # # ### # # ####### # ####### # ####### # # ### ######### ### ### # # # 
 #     # # #     # # #   #   # # # # # # #   #   # #   #   # # #   #   # #     #     # # # # #   # # 
 # ##### # ### ##### # # # ### # # # ### ### # ### # ####### ##### ##### # ##### ### # # # # # ### # 
 #     # #   # # #   # # # #   # #   #   # # # #     #     # #   # #     # #   #   #   # #   # #   # 
 ##### ##### # # # ##### # # ### ### # # # # # ####### ### # # # # # ##### # # ############# # ##### 
 #   #     # #   #       # #   #   # # # #   #       # # #   # # # #     # # #   #       #   #     # 
 # ##### ### ################# ### ### ### ######### # # ### # # # ##### # # ### # ##### # ####### # 
         #       #   # #   #   # #   # # # #   # #   #   #   # # # #     # # # #   #   #   #       # 
########## ##### ### # # # # ### ### ### ### ### # ##### # ### # # # ##### # # ##### # ##### ####### 
     # #   #   # #   #   # #     # # #   #     #   #     #   # #   # #   # #   #   # # # #   #   #   
 ### # # ### # # # ### ### # ##### # # ### # # ##### ####### # ##### # # # ##### ### # # # ### ### ##
   # # # # # # # #     #   # #   # # #   # # #   # #     # # #       # #   #   #     # # # #   #   # 
#### # # # # # # ####### ##### # # # ##### # ### # ### # # # ######### ##### # # ### # # # # ### ### 
     # #   # # #       # #     # #   #   # #   #   # # #   #   #         # # # # #   #   # #     #   
## ####### # ### ##### ### ##### ##### # # ### # # # ##### ### # ######### # # ### ##### # ######### 
 # # #     #   #   #     # #     #   # # # #   # # #     #   # #         # # #     #   # # #   #   # 
 # # # ##### # ### ##### ######### # # # ### ### ####### ### # ######### # # ######### # # ### # # # 
 # # # # #   #   #     #     #     #   # #   #   #     #   # # #   #   # #   #     #   # #   # # # # 
 # # # # # ##### ######### # # ######### # ### ### ### ### # # ### # # # ########### ### ### # # # # 
 # # #   #     # #       # # #     #     # #   #     #   # # # #   # # #         #   #     #   # # # 
 # # ########### ##### # # ######### ##### # ### ### ### # # # # ##### ####### # # ##### # # ### # # 
   #   #     # #   #   #   #         #     #     #   #   # # # #     # # #   # #   #   # # #     # # 
###### # ### # ### ######### ######### ############# # # # ### ##### # # # # ######### # ######### # 
     # #   # #   #   #     # #       #     #       # # # #   #       #     #   #       #   #     #   
 ### # ##### ### ### # ### # # ##### ##### # ##### # # ##### ################# ##### ##### # ########
 #   #     #   # #   #   # # #   # #   #   # #     # #     # #     # #   # #   #     #   # #         
 # ####### ##### # ##### # ##### # ### ##### # ########### # # ### # # # # # ### ######### ######### 
 #     #   #   # #   #   #     #   #   #     #     #   #   #   # # #   # # # #   #     # #   # # #   
 ##### ##### # # ### # ####### ### # ### ######### # # # ####### # ##### # # # ### ### # # ### # # ##
     # #   # #   #   # #   # # #   #     #   #   #   #   #   #   # #   # #   #     #   # #   #   #   
## # # ##### ##### ### # # # # # # ####### # ############# # # ### ##### ########### ####### # ##### 
   # #   ### #       #   # # # # #       # #     #   #     # #     #   # # #   #     #     # #   #   
#### ### ### # ##### ####### # ######### # ##### # # ####### ####### # # # # # ### # # # ### ### # ##
     #   #   #   #   # #   # #   # #   # # #   #   #   #   # # #     # #   # #   # # # # #   #   #   
 ######### ####### ### ### # ### # # ### # # # ######### # # # # ######### ### # # # # # # ##########
 #   #   # # #     #   #   #   # # #   #   # #   #       # # # #   #   # # #   # # # # # #   #   #   
 # # # ### # # ##### ### ##### # # ### ##### ### # ##### ### # ### # # # # # ##### # # # ### # # # # 
   # # # # # #     #   # #     #       #   #   #   #         #   #   # # #   #   # # # #   #   # # # 
#### # # # ####### ### ################# # ### ####################### # ##### # # # ##### ### # ### 
   #     #         # #     #   #   #   # #   #   #     #     #           #     #   # #   #   # #     
 # ### ############# ##### ##### # ### # ####### ##### # ##### ####### ##### ####### # # ### ########
 # #   #   # #     #     #     # #       #     # #   # # #     # #   #       #     #   #   #         
 # # ##### # # # # ##### ##### # ######### ### # # # # # # # ### # ########### # ####### # # ####### 
 #   #   # #   # # #     #     #   #   #   #   # # # #   # #     #     #   #   #   #   # # # # #   # 
###### # # ##### # # ##### ####### ### # ### ### # # ##### ########### # # # ##### # # # ### # # ####
       #   # #   # #     # #     # # # #   #     # # #         # #   # # #   #   # # # #   #   #     
 ########### # ### ##### # # # ### # # ### ############# ##### ### # ### ##### # # # # ### ### ##### 
   # #   # #   #   #     #   #     # #   #     #         #   # #   # # # #     # #   #   #   #   # # 
## # # # # ##### ### ### ########### ### ##### ####### ##### ### ### # # # ##### ##### # ### ### # # 
 #   # #     #   #     # # #     # #         #         #   #   # # # # # # #     #     #   #   # #   
 ##### ##### ####### # ### ##### ######### ############# # # # # # # # # ### ### ######### ### # ####
 #   # #   # #   #   #   #       #   #   #     #     #   # # # #   #   # #   #   #     #     # #     
 # # # # # # # # # ### # ######### # ######### # ### # ### ### ######### # ### ### ### ##### # # ### 
 # # # # #   # #   #   #           # #   #   # #   # # # # #   #       #   #   #   #     # #   # #   
###### # ##### # ### ### ### ####### # # # ### ### ### # # # ### ##### ######### ####### # ##### ####
     # # #   # # #   #   #   #   #   # # # #     #     # # # #   #     #   #   #       # #     #   # 
## # # ### # # # ########### # # # ##### # # ########### # # # ### ### # # # ######### # ##### ######
 # # #     #   #   # #     #   # #     #   # #     #   # # # # #   #   # # #     #   # #   #         
 # # ### ######### # # # # ####### ### ##### ##### # # # # # # ##### ### # ##### ### # ### # ####### 
   # #   #       #   # # #   #   # # # #   # #     # #   #   #   #   # # # #   #   #   #   # # #   # 
###### # # ######### ### ##### # # # # ##### # ##### ########### # ### # # ### ### ### # ### # # ### 
 #     # # #         #   # #   # # #   #   #   #   #     #     # #   #   #     #   # # #     #   #   
 # ####### # ######### ##### ### # ####### ####### # ##### ##### ### ### ####### ### # ##############
 # #   #   #   #     #     #   # # #     # #     # #         #     #   #         #   #               
 # # # # ##### # ### ##### # # ### ##### # # ### # # ####### # ####### ########### # ############# ##
 # # # # #     # # #   #     # #   #   # #     #   # #       # #     # #         # #   #         #   
## # ### # ##### ##### ####### # ##### # ########### # ####### ##### # ######### ##### # ####### ### 
   #   # # #   # #   #       # # #   #   # #       # # #   # #       #   #   #         # # #   #   # 
 ##### # # # # ### # ####### # # ### ##### # ##### ### # ### ########### ### # ####### # # # # ##### 
     #   #   #   # #   #   # # #   #   #   #   # #     #         #         #   #     # #   # #     # 
## ############# ##### # # # # # # # # # ##### # ####### ### ### # ####### # ##### # # ##### ####### 
 #   #   #     #       # # #   # # # #       # # #       # #   #   #       #   #   # # # #   #     # 
 ### # # # ############# ##### ### ######### # # ####### ##################### # ### # ### ####### # 
 #   # # # #   #         # #     #   #     #     #     # #       #   #         # # # #     #   #   # 
 # ####### # # # ######### ##### ### # ### ### ### ### ### ####### # # ######### ### ####### # # ### 
 #       # # # # #         #   #   #   #   #   #   #     # # #     #   #   #     #   #       #   #   
 ####### # # # # # # ####### # ####### # ####### ####### # # # ########### # # ### # ############# ##
 # ###   # # #     # #       # # #     # #     # #     # #   #             # #   # # #     #     # # 
 # ### ### # ######### ####### # # ####### ### # ####### ############### ####### # ### ### ##### # # 
 # #   #   # #       #   #   # # # #   #   #   # #     #               #       # #     #   #   # #   
 ### ### ### # ##### ### # # # # # # ### ##### ### ### ############### ######### ####### # # # # ####
     #   #   #   # # #   # #       # #   #   # #   #   # # #     #   #   #     #   #     # # # # #   
###### ######### # # # ############# # ##### # # ##### # # # ### # # ### ##### ##### ##### ### # # # 
 #     # #     #   #   #   #   #   # #   #   # # #   #   # #   #   #   #   # #   #   #   #   # # # # 
 # ##### # ### ####### # # # # # ### ### # ### ### # ### ##### ####### ##### ##### ### # ### # # ### 
 # #     #   #     #     # # # #     # # # #   #   #   #     #   #   #     # # #   #   #   #   # #   
 # # ############# ####### # # ######### # # ### ##### ##### ### ######### # # # ##### ### ##### # ##
 # #   # #       # #       # # #   #     # #   # #   #   # #   # #   #   # # # #     #   #   #   #   
 # ##### # ##### # # ####### ### ####### # # ##### # ### # ### # # # ### # ######### ### ### # ##### 
   #   # # #   #   #     # # #   # #   # # # #   # #     # #   # # #   # #       # # #   #   #       
#### # ### # # ######### # # # ### # ### # # # ### ######### ### # ##### ####### # # ##### ##########
     # #   # # #       # # # # #   #     #   #   #   #     #   # #       #   #     #     # # #       
 ### # # # # ### ##### # # # # # ############### ### # ### ### # # ####### # # ######### # # # ### B 
 #   #   # #     #   #   # #   #               #       #       # #         #   #           # #   # # 
           #   #         # #     # #     #   #   #     #   #       #               #       #   #   # 
