########################################
#A    #    #   #   #     ###############
# ###### ##### ##### ### ### ### ##### #
#       #    #  #  #  #   ##############
#####   ### # ######### # ##### ##### ##
#  # #   #    #  #   #  #  #############
# # ##  ####### ### ### ##### ### ### ##
# #         # #  # #  # #   # ##########
### ### #   ##### ##### # # ### ##### ##
#   # # #       # # #   # #  ###########
##### # ###   # ##### ##### ##### # ####
#  # #          #  #    #  #############
# # ##### ####### ####### ########### ##
# #   #    #    #  #   #  ##############
# ##### ##### # ########### ##### ### ##
#        #    #    #    ################
##### ##### ##### ### ### ####### ######
#   #      #  #  #    # #   ############
### ##### ####### ### ### ##### ### ####
#  #  #    # #  #  #   #   # ###########
# ### ### ##### # # ########### ########
# #  #  #   # #      #     #############
# ### ###   ##### ######### ##### ######
# #   #  #      #  #    #  #############
# ########### ######### ##### ##########
#  #   #          #  #    ##############
### ##### ### ####### ####### # ########
#  #      #    #    #    # #############
# ##### ##### ##### ##### ### ### ######
#   #    B  # #   # #  # #  # ##########
# ### ### ######### # ##### ##### ### ##
#  #  #       #  #  #  # #   ###########
# ##### ### ##### ######### ##### ### ##
#    #    #     #     #  ###############
########################################